PPPPPPPPP-
P-------P-
P-PPPPP-P-
P-P---P-P-
P-P-S-P-P-
P-P-P-P-P-
P-P-PPP-P-
P-P-----P-
P-PPPPPPP-
E---------
