----------
----------
-----SP---
------P---
------P---
-----PP---
-----P----
-PPPPP----
-P--------
-PPPPPPPE-
